ShikakuJoutai=資格状態
ShinseiJouhou=申請情報
HonshishoKbn=本支所区分
ShinsheiJiyu=申請事由
ShinsheiRiyu=申請理由
Henkoudate=変更日
ShintatsuDate=進達日
ShinseiBikou=申請備考
ShinseiShaTab15Miman_Txt=※申請者（対象者）が15才未満の場合は保護者を入力
Jidou=児童
BirthDate=生年月日
Seibetsu=性別
TeiShutsuSha=提出者
Atena=宛名
Shime=氏名
Kanashimei=カナ氏名
Kyojuuchi=居住地
Zokugara=続柄
DenwaNo=電話番号
KetteiJouhou=決定情報
HanteiDate=判定日
HanteiKekka=判定結果
HanteiRiyuu=判定理由
DaichouJouhou=台帳情報
Dai=第
Gou=号
TechouNoShutoku=手帳番号取得
ShokaiKoufuDate=初回交付日
SaikoufuDate=(再)交付日
ShogaiToukyu=障害等級
ShutaruShogaiBui=主たる障害部位
TechouHenkanDate=手帳返還日
HenkanRiyuu=返還理由
ShogaiMei=障害名
ShidouKiroku=指導記録
DaichouBikou=台帳備考
FukugouShogaiJouhou=複合障害情報
ShogaiJouhouTsuika=障害情報追加
Meisai=明細
RirekiNo=履歴番号
ShinseiDate=申請日
UketsukeNo=受付番号
KetteiDate=決定日
ShubetsuToukyu=種別・等級
TechouNo=手帳番号
Sentaku=選択
EditTitle=編集
ShogaiBui=障害部位
BuiToukyu=部位等級
ShogaiNinteiDate=障害認定日
SaiNinteiMonth=再認定年月
ShogaiNaiyou=障害内容
EditBtn=確定
DeleteBtn=削除
CloseBtn=閉じる
HoumonkangoJigyouShaIryouKikanNo1=訪問看護事業者医療機関番号1
HoumonkangoJigyouShaIryouKikanNoMeishou1=訪問看護事業者医療機関番号名称1
HoumonkangoJigyouShaIryouKikanNo2=訪問看護事業者医療機関番号2
HoumonkangoJigyouShaIryouKikanNoMeishou2=訪問看護事業者医療機関番号名称2
HoumonkangoJigyouShaIryouKikanNo3=訪問看護事業者医療機関番号3
HoumonkangoJigyouShaIryouKikanNoMeishou3=訪問看護事業者医療機関番号名称3
Sonohoka=その他
ShintaiShogaiShaTechouBui=身体障害者手帳部位
ShinseiRiyuu=申請理由
ShintaitsuDate=進達日
Tennyuu=転入
IryouKikan=医療機関
ShutaruSeishinShogaiCode=主たる精神障害コード
ShutaruSeishinShogai=主たる精神障害
JuutaruSeishinShogaiCode=従たる精神障害コード
JuutaruSeishinShogai=従たる精神障害
TenpuShoruiMei=添付書類名
TenpuShoruiMei1=添付書類名_1
TenpuShoruiMei2=添付書類名_2
TenpuShoruiMei3=添付書類名_3
TenpuShoruiMei4=添付書類名_4
TenpuShoruiMei5=添付書類名_5
TenpuShoruiMei6=添付書類名_6
TenpuShoruiMei7=添付書類名_7
TenpuShoruiMei8=添付書類名_8
TenpuShoruiMei9=添付書類名_9
TenpuShoruiMei10=添付書類名_10
Honnin=本人
HogoSha=保護者
HanteiKetteiJouhou=判定・決定情報
HanteiRiyu=判定理由
DaichoJouhou=台帳情報
ShogaiTeido=障害程度
YuukouKigen=有効期限
RirekiJouhou=履歴情報
SelectBtn=選択
ShinseiJiyuu=申請事由
